@@@@@@@@@@@@@@@@@@@@@@@@@@@@@@@@@@@@@@@
@@@@@@@@@@@@@@@@@@@@@@@@@@@@@@@@@@@@@@@
@@@@@@@#######@@@@@@@@########@@@@@@@@@
@@@@@@@#######@@@@@@@@########@@@@@@@@@
@@@@@@@##@@###@@@@@@@@###@@###@@@@@@@@@
@@@@@@@##@@###@@@@@@@@###@@###@@@@@@@@@
@@@@@@@#######@@@@@@@@########@@@@@@@@@
@@@@@@@@@@@@@@@@@@@@@@@@@@@@@@@@@@@@@@@
@@@@@@@xxxxxxxxxxxxxxxxxxxxxxxx@@@@@@@@
@@@@@@@@@xxxxxxxxxxxxxxxxxxx@@@@@@@@@@@
@@@@@@@@@@#@@@@@@@@@@@@@#@@@@@@@@@@@@@@
@@@@@@@@@@###############@@@@@@@@@@@@@@
@@@@@@@@@@@@@@@@@@@@@@@@@@@@@@@@@@@@@@@
@@@@@@@@@@@@@@@@@@@@@@@@@@@@@@@@@@@@@@@
